	EA      mandatory/textures/east.xpm
	NO              mandatory/textures/north.xpm
 SO        mandatory/textures/south.xpm
		WE                              mandatory/textures/west.xpm

F 210,180,140
C 75,144,226

11111111111111
10010000010001
10010000010001
100D000N0D0001
10010000010001
10010000010001
11111111111111
