
C 0,0,0
F 0,0,0

EA bonus/textures/east.xpm
NO bonus/textures/north.xpm
SO bonus/textures/south.xpm
WE bonus/textures/west.xpm


1111111111111111111
10000000000001000001
1000000000000D000001
10000000000001000001
10000000000001111111
10000000000000000001
10000000000000000001
10000000000000000001
10000000000000000001
10000000000000000001
100000000E0000000011
10000000000000000001
10000000000000000001
10000000000000000001
10000000000000000001
10000000000000000001
10000000000000000001
10000000000000000001
10000000000000000001
1111111111111111111
